##########
#........#
#.P......#
#........#
#........#
#........#
##########