##########
#........#
#.....P..#
#........#
#........#
#........#
##########