##########
#.......E#
#.....P..#
#........#
#....E...#
#........#
##########