#####################
#.......E.#.........#
#.....P...#.........#
#...............P...#
#....E..............#
#................E..#
#.........#.........#
#.........#.........#
####...#######...####
#.........#.........#
#..P......#....E....#
#...................#
#...................#
#..............P....#
#.....E...#.........#
#.........#.........#
####...#######...####