#####################
#.........#.........#
#.....H...#.........#
#........G......H...#
#...................#
#.....E..........E..#
#.........#...G.....#
#.........#.........#
####...#######...####
#.........#.........#
#..H......#....E....#
#...................#
#......G.........G..#
#..............H....#
#.....E...#.........#
#.........#......E..#
####...#######...####